152
15
36 36 36 36 36 36 36 36 36 36 36 36 36 36 36 36 36 36 36 36 36 36 36 36 36 36 36 36 36 36 36 36 36 36 36 36 36 36 36 36 36 36 36 36 36 36 36 36 36 36 36 36 36 36 36 36 36 36 36 36 36 36 36 36 36 36 36 36 36 36 4 0 0 0 0 0 0 0 0 0 0 0 0 0 0 0 0 0 0 0 0 0 0 0 0 0 0 0 0 0 0 0 0 0 0 0 0 0 0 0 0 0 0 0 0 0 0 0 0 0 0 0 0 0 0 0 0 0 0 0 0 0 0 0 0 0 0 0 0 0 0 0 0 0 0 0 0 0 0 0 0 0 
36 36 36 36 36 36 36 36 36 36 36 36 36 36 36 36 36 36 36 36 36 36 36 36 36 36 36 36 36 36 36 36 36 36 36 36 36 36 36 36 36 36 36 36 36 36 36 36 36 36 36 36 36 36 36 36 36 36 36 36 36 36 36 36 36 36 36 36 36 36 4 0 0 0 0 0 0 0 0 0 0 0 0 0 0 0 0 0 0 0 0 0 0 0 0 0 0 0 0 0 0 0 0 0 0 0 0 0 0 0 0 0 0 0 0 0 0 0 0 0 0 0 0 0 0 0 0 0 0 0 0 0 0 0 0 0 0 0 0 0 0 0 0 0 0 0 0 0 0 0 0 0 
36 36 36 36 36 36 36 36 36 36 36 36 36 36 36 36 36 36 36 36 36 36 36 36 36 36 36 36 36 36 36 36 36 36 36 36 36 36 36 36 36 36 36 36 36 36 36 36 36 36 36 36 36 36 36 36 36 36 36 36 36 36 36 36 36 36 36 36 36 36 4 0 0 0 0 0 0 0 0 0 0 0 0 0 0 0 0 0 0 0 0 0 0 0 0 0 0 0 0 0 0 0 0 0 0 0 0 0 0 0 0 0 0 0 0 0 0 0 0 0 0 0 0 0 0 0 0 0 0 0 0 0 0 0 0 0 0 0 0 0 0 0 0 0 0 0 0 0 0 0 0 0 
36 36 36 36 36 36 36 36 36 36 36 36 36 36 36 36 36 36 36 36 34 34 34 34 36 36 36 36 36 36 36 36 36 36 36 36 36 36 36 36 36 36 36 36 36 36 36 36 36 34 34 36 36 36 36 36 36 36 36 36 36 36 36 36 36 36 36 36 19 17 0 0 0 0 0 0 0 0 0 0 0 0 0 0 0 0 0 0 0 0 0 0 0 0 0 0 0 0 0 0 0 0 0 0 0 0 0 0 0 0 0 0 0 0 0 0 0 0 0 0 0 0 0 0 0 0 0 0 0 0 0 0 0 0 0 0 0 0 0 0 0 0 0 0 0 0 0 0 0 0 27 0 
34 34 34 36 36 36 36 36 36 36 36 36 36 36 36 36 36 36 36 36 36 34 34 34 34 34 36 36 36 36 36 36 36 36 36 36 36 36 36 36 36 36 36 36 36 36 36 34 34 34 36 36 36 36 36 36 36 36 36 34 36 36 36 36 36 36 36 19 0 0 0 0 0 0 0 0 0 0 0 0 0 0 0 0 31 0 0 0 0 0 0 0 0 0 0 0 0 0 0 0 0 0 0 0 0 0 0 0 0 1 35 2 0 0 0 0 0 0 0 0 0 0 0 0 0 0 0 0 0 0 0 0 0 0 0 0 0 0 0 0 0 0 0 0 0 0 0 0 0 0 37 38 
34 34 34 34 36 36 36 36 36 36 36 36 36 36 34 34 36 36 36 36 36 36 36 34 34 34 34 34 34 36 36 36 36 36 36 36 36 36 36 36 36 36 36 36 36 36 36 34 34 34 34 36 36 36 36 36 36 34 36 34 36 36 36 36 36 36 36 4 0 0 0 0 0 0 0 0 0 0 0 0 0 0 0 1 35 35 35 2 0 0 0 1 35 2 0 0 0 0 0 0 0 0 0 0 0 0 0 1 35 35 35 35 2 0 0 0 0 1 35 2 0 0 0 0 0 0 9 0 0 0 29 0 0 0 11 0 0 0 0 0 0 0 0 0 0 0 0 0 0 0 0 0 
34 34 34 34 34 34 34 36 36 36 36 36 34 36 34 34 34 36 34 36 36 36 36 36 36 34 34 34 34 34 36 36 36 36 36 36 36 36 36 36 36 36 36 36 36 36 36 36 34 34 36 36 36 36 36 36 36 34 34 34 36 36 36 36 19 17 17 0 0 0 0 0 0 0 0 0 0 0 0 0 0 0 0 3 36 5 35 35 2 0 28 3 36 4 0 0 0 0 0 0 0 0 0 0 0 1 35 35 6 36 36 5 35 35 35 35 35 35 6 4 0 0 1 35 35 35 35 35 35 35 35 35 35 35 35 2 0 0 0 0 0 0 0 0 37 38 39 0 0 0 0 0 
36 34 34 34 34 34 34 34 34 34 34 34 34 34 34 34 34 34 34 34 34 34 34 34 36 36 36 36 36 36 36 36 36 36 36 36 36 36 36 36 36 36 36 36 34 34 34 36 36 36 36 36 36 36 36 36 36 34 34 34 36 36 36 36 4 0 0 0 0 0 0 0 0 0 0 0 0 0 0 0 32 38 33 0 18 36 5 35 35 35 35 35 6 4 0 0 0 0 37 38 39 0 0 0 0 3 36 36 36 36 36 36 36 36 36 36 36 36 19 0 0 0 0 17 17 17 18 36 36 36 36 36 36 36 19 0 0 0 0 0 31 0 0 0 0 0 0 0 0 0 0 0 
36 36 34 34 34 34 34 34 34 34 34 34 34 34 34 34 34 34 34 34 34 34 34 34 34 34 34 34 36 36 36 36 36 34 34 34 36 36 36 36 36 36 34 34 34 34 34 34 34 36 36 36 36 36 36 36 36 36 36 36 36 34 34 36 4 0 0 0 0 0 0 0 0 0 0 0 0 0 0 0 0 0 0 0 21 36 36 36 36 36 36 36 36 4 0 0 0 0 0 0 0 0 0 0 0 3 36 36 36 36 36 36 36 36 36 36 36 36 4 0 0 0 3 36 36 36 0 17 17 17 17 17 17 17 0 36 4 0 0 0 37 39 0 0 0 0 0 0 0 0 0 0 
36 36 36 36 36 34 34 34 34 34 34 34 34 34 34 34 34 34 34 34 34 34 34 34 34 34 34 34 34 34 34 34 34 34 34 34 36 36 36 36 36 36 36 34 34 34 34 34 34 36 36 34 34 34 34 34 36 34 34 34 34 34 34 34 27 0 0 0 0 0 0 0 0 0 0 0 0 0 0 0 0 0 0 3 36 36 36 36 36 36 36 36 36 4 0 0 0 0 0 0 0 0 0 0 0 3 36 36 36 36 36 36 36 36 36 36 36 36 4 0 0 0 3 36 36 36 0 0 0 0 0 0 0 0 36 36 4 0 0 0 0 0 0 0 0 0 0 0 0 0 0 0 
36 36 36 36 36 36 36 36 34 34 34 34 34 34 34 34 34 34 34 36 34 34 34 34 34 34 34 34 34 34 36 34 34 34 34 34 34 34 36 36 36 36 36 36 36 36 36 36 36 36 34 34 34 34 34 34 34 34 34 34 34 36 36 36 35 35 35 2 0 0 0 0 0 9 0 0 0 37 38 39 0 0 0 3 36 36 36 36 36 36 36 36 19 0 0 0 0 0 0 0 0 0 0 0 0 3 36 36 36 36 36 36 36 36 36 36 36 36 4 0 0 0 3 36 36 36 36 36 0 0 0 0 0 36 36 36 4 0 0 0 0 0 0 0 0 0 0 0 0 0 0 0 
36 36 36 36 36 36 36 36 36 36 34 34 34 34 34 34 34 34 34 36 34 34 36 36 34 34 34 34 34 34 36 34 34 34 34 34 34 34 34 34 34 34 34 34 34 34 34 34 34 34 34 34 34 34 34 34 34 34 34 34 36 36 36 36 36 36 5 35 2 0 0 0 37 38 39 0 0 0 0 0 0 37 39 3 36 36 36 36 36 36 36 36 4 0 0 0 0 0 0 0 0 0 0 0 0 3 36 36 36 36 36 36 36 36 36 36 36 36 4 0 0 0 0 18 36 36 36 36 0 0 0 0 0 36 36 36 4 0 0 0 0 0 0 0 0 0 0 0 0 0 0 0 
36 36 36 36 36 36 36 36 36 36 36 36 34 34 34 34 34 36 34 36 36 36 36 36 34 34 34 34 34 36 36 34 34 34 34 34 34 34 34 34 34 36 36 36 36 36 34 34 34 34 34 34 34 34 34 34 36 34 34 36 36 36 36 36 36 36 36 5 35 2 0 0 0 0 0 0 0 0 0 0 0 0 0 3 36 36 36 36 36 36 36 36 4 0 0 0 0 0 0 0 0 0 0 0 0 3 36 36 36 36 36 36 36 36 36 36 36 36 4 0 0 0 0 0 18 36 36 36 36 36 36 36 36 36 36 19 0 0 0 0 0 0 0 0 0 0 0 0 0 0 0 0 
36 36 36 36 36 36 36 36 36 36 36 36 36 34 34 34 34 36 36 36 36 36 36 36 34 34 34 36 36 36 36 34 34 34 34 34 34 34 36 36 36 36 36 36 36 36 36 36 34 34 34 34 34 34 34 34 36 36 34 36 36 36 36 36 36 36 36 36 36 4 0 0 0 0 0 0 0 0 0 0 0 0 0 3 36 36 36 36 36 36 36 19 0 0 0 0 0 0 0 0 0 0 0 0 0 3 36 36 36 36 36 36 36 36 36 36 36 36 4 0 0 0 0 0 3 36 36 36 36 36 36 36 36 36 36 4 0 0 0 0 0 0 0 0 0 0 0 0 0 0 0 0 
36 36 36 36 36 36 36 36 36 36 36 36 34 34 34 34 34 36 36 36 36 36 36 34 34 34 34 36 36 36 36 36 36 36 36 36 36 36 36 36 36 36 36 36 36 36 36 36 36 36 36 34 34 36 36 34 36 36 36 36 36 36 36 36 36 36 36 19 17 0 0 0 0 0 0 0 0 0 0 0 0 0 0 3 36 36 36 36 36 36 19 0 0 0 0 0 0 0 0 0 0 0 0 0 0 3 36 36 36 36 36 36 36 36 36 36 36 19 0 0 0 0 0 0 3 36 36 36 36 36 36 36 36 36 19 0 0 0 0 0 0 0 0 0 0 0 0 0 0 0 0 0 
